NO textures/256cobble.xpm
WE textures/256mosscobble.xpm
SO textures/256mosscobble.xpm
EA textures/256cobble.xpm


C 135,206,235
F 127,0,0


00000000000000000000000000001
11111111111111111111111111110
10100000001101000000000000001
10110104011100000000000010001
100100000000000000000000010001
10110000011100000000000010001
10000000001100000111011110001
11110111111111011100000010001111111111111111111111111111
11110110011111011100000010000000000                    1
11000000110101011101010010000000000          11        1
10000000000000001100000010000000000     11   11        1
100000000000000011010100100011111101    01       11    1
11000000110101000000000000001    1 1             11    1
11110111110101000000000000001    1 1                   1
1000000001110000010000001000111111 1  11     11        1
1000000000000000101000010100       1  11     11        1
1000000000100001000101000100111111 1               4   1
10000000001101000000100000001    1 1      11      11   1
10000000000100000001010000001    1 1      11      11   1
11111111111101011111111111111    1 1                   1
           10101                 1 1  114              1
           10101111111111111111111 1  11      11       1
           10000                   1          11       1
           111111111111 111111111111     11        11  1
                      1 1          1     11        11  1
11111111111111111111111 1111111111111   11111    1111  1
1                                                      1
1 3                                          1111111   1
1  2                            2            14E    4   1
1 4   3   3   3   3   3   3   3   3   3   3  1111111   1
1                                                      1
11111111111111111111111111111111111111111111111111111111
