NO textures/256cobble.xpm
            WE textures/256mosscobble.xpm
SO textures/256stone.xpm
EA textures/256stone2.xpm


C 102,102,102
F 37,49,32


     11111111111111111111111111111111111111111
11111110000000000000000000000000000000000000001
    10000000000000N0000000000000000000000000001
    1011111111111111111111111111111111111111111
1111101           111111                   1111
1000001           100001                   1001
1000111           100001                   1001
10001             100001                   1001
 1011111111111111111111111111111111111111111111
 1011111                                 111111
 1000000111111111111111111111111111111111111111
11111110000000000000000000000000000000000000001
    1000000000000060000000000000000000000000001
    1111111111111111111111111111111111111111111
                    1
11111             111111                   1111
10001             100001                   1001
10001             100001                   1001
10001             100001                   1001
 1111111111111111111111111111111111111111111111
              112111
              113111   1
                145111161
              111111   1
