NO textures/256cobble.xpm
WE textures/256mosscobble.xpm
SO textures/256stone.xpm
EA textures/256stone2.xpm


C 102,102,102
F 37,49,32


11111111111111111111111111111
10000000001100000000000000001
10110100011100000000000010001
10610000000000000000000110001        
10110000011100000000000510001
10000000051100000111011110001
11110111111111011100000010001111111111111111111111111111
11110113211111011100000010000000000000000000000000000001
11000000115151011101010010000000000000000000011600000001
10000000000000001102300010002230000000001100011200000001
10000000000000001101010010001111110100000100032221100001
11000000110101000000000000001    10100000000002001120001
11110111110101000000000000001    10100000000000000000001
10000000011100000100000015001111110100110000011000000001
10000000000000001715000101000000000100110000011000000001
10000000001000010001110001001111110100700002000000000001
10000000001101000000000000001    10100000011200000113001
10000000006100000001010000001    10100000011200000113031
11141111111101011111111111111    10100000000020000000301
1000000000510101                 10100110000000000000001
10000000000101011111111111111111110100110000001100000001
10000000000100000000000000000000000100000000001100000001
12000000000111111111111011111111111100000110000000011001
1520000000000000000007101          150000115000000511001
11111111411111111114111011111111111110001111100001111001
13000000000000000000002220000000000230000000000000000001
12200000000000000000000200000000000000000000011111110021
122300000000000000000000000000000000000000000160E0040021
12200000000000000000000000000000000000000000011111110001
13000000000000000002000000020000000000000000000000000031
11111111111111111111111111111111111111111111111111111111
