


         WE                textures/256mosscobble.xpm

 NO                                         textures/256cobble.xpm

                                                 NO    textures/256mosscobble.xpm

EA textures/256cobble.xpm




C 135,206,235

F 127,0,0


111111111111111111111111111111
1W041           
11111                        
