WE textures/256mosscobble.xpm


NO textures/256cobble.xpm

SO textures/256mosscobble.xpm

EA textures/256cobble.xpm




C 135,206,235

F 127,0,0

1111111111111111111111111111
10000000001101000000000000001
10110100011100000000000010001
10010000000000000000000010001
10010000000000000000000010001
10110000011100000000000010001
10000000001100000111011110001
1111011111111101110000001000111111111111
1111011011111011100000010000000001
11000000110101011101010010000000001
1000000000000000110000001000000000011
100000000000000011010100100011111101
110000001101010000000000000010001111
1111011111010100000000000000100011
10000000011100000100000010001111111
100000N0000000001010000101000000001
10000000001000010001010001001101111
10000000001101000000100000001101111111111111111111
1000000000010000000101000000100000000000000000011111111
111111111111111111111111111110000000000000000001
1111101           111111     111111111111110001
1000001           100001                   1001
1000111           100001                   1001
10001             100001                   1001
 1111111111111111111111111111111111111111111111
