NO textures/stone_block.xpm
WE textures/brick.xpm
SO textures/stone_macadam.xpm
EA textures/mossycobble2.xpm




C 135,206,235

F 127,0,0

1111111111111111111111111111
10000000001101000000000000001
10110100011100000000000010001
10010000000001000000000010001
10010000000000100000000010001
10110000011100010000000010001
10000000001100000111011110001
1111011111111101110000001000111111111111
1111011011111011100000010000000001
11000000110101111101010010000000001
10000000000001  110000001000000000011
1000000000000011011010100100011111101
110000001101010000001000000010001111
1111011111010100000010000000100011
10000000011100000100100010001111111
100000N0000000001010000101000000001
10010000001000010001010001001101111
10010000001101000000100000001101111111111111111111
1000001000010000000101000000100000100000000000011111111
111110111111111111110001111111000000010000000001
1111101           110111     111111111111110001
1000001           100001                   1001
1000111           101001                   1001
10001             100001                   1001
 111             100011                    111
                1000001
                10000001
               1000100001
               1000110001
                10011001
                 101101
                  1111
