


                             WE          textures/256mosscobble.xpm


              EA                                               textures/256cobble.xpm


  NO            textures/256cobble.xpm


            SO textures/256mosscobble.xpm





                                        C                        255,0,0


                                                                           F 0,230,0


     11111111111111111111111111111111111111111
11111110000000000000000000000000000000000000001
    10000000000000N0000000000000000000000000001
    1111111111111111111111111111111111111111111
11111             111111                   1111
10001             100001                   1001
10001             100001                   1001
10001             100001                   1001
 1111111111111111111111111111111111111111111111
                                         111111
