

NO textures/cobble.xpm
EA textures/sandstone_brick.xpm

SO textures/wood.xpm

WE textures/mossycobble.xpm



C 135,206,235

F 102,0,0
111111
10S101 
101001
1000W1
111111
