NO textures/256cobble.xpm
WE textures/256mosscobble.xpm
SO textures/256mosscobble.xpm
EA textures/256cobble.xpm


C 135,206,235
F 127,0,0


11111111111111111111111111111
10000000001100000000000000001
10110100011100000000000010001
10010000000000000000000010001
10110000011100000000000010001
10000000001100000111011110001
11110111111111011100000010001111111111111111111111111111
11110110011111011100000010000000000000000000000000000001
11000000110101011101010010000000000000000000011000000001
10000000000000001100000010000000000000001100011000000001
10000000000000001101010010001111110100000100000001100001
11000000110101000000000000001000010100000000000001100001
11110111110101000000000000001000010100000000000000000001
10000000011100000100000010001111110100110000011000000001
10000000000000001010000101000000000100110000011000000001
10000000001000010001010001001111110100000000000000000001
10000000001101000000100000001000010100000011000000110001
10000000000100000001010000001000010100000011000000110001
11111111111101011111111111111000010100000000000000000001
10000000000101010000000000000000010100110000000000000001
10000000000101011111111111111111110100110000001100000001
10000000000100000000000000000000000100000000001100000001
10000000000111111111111011111111111100000110000000011001
10000000000000000000001010000000000100000110000000011001
11151111111111111115111011111111111110001111100001111001
10000000000000000002000000020000000000000000000000000001
100N0000000000000000020002000000000000000000011111110001
10000000000000000000000200000000000000000000010000000001
10000000000000000000020002000000000000000000011111110001
10000000000000000002000000020000000000000000000000000001
11111111111111111111111111111111111111111111111111111111
