NO textures/256cobble.xpm
WE textures/256mosscobble.xpm
SO textures/256stone.xpm
EA textures/256stone2.xpm


C 102,102,102
F 37,49,32


111111111111111111111111111111111111111111111111111111111111111111111111111111111111111111111111111111
1                                                                                                    1
1                                                                                                    1
1                                                          111111111111111111                        1
1                                                        1                    1                      1
111111111111111111111111111111111111111111111111111111111111                11111111111111111111111111
                                                           1                1      
                                                           1     11111111   1
                                                           1     1      1   1
11111111111111111111111111111111111                        1     1      1   111111111111111111
1                                 1                        1     11111111                    1
1              S                  1                        1                1111111111111111 1
1                            11   1                        1     1111111 1111             11 1
1   1111111111111111111111111111  1                        1  11 1     1 1  1111111111111111 1
1   1                             1                        1  11 1     1 1                   1
1   1111111111111111111111111111111                        1 111 1     1 111111111111111111111
1                                 1                        1 111 1111111 1
111111111111111111111111111111111 11111111111111111111111111 111    111  1
                                1                              1111 111 11
                                111111111111111111111111111111          1
                                                             111111111111                              
