NO textures/256cobble.xpm
WE textures/256mosscobble.xpm
SO textures/256stone.xpm
EA textures/256stone2.xpm


C 102,102,102
F 37,49,32


111111111111111111111111111111111111111111111111111111111111111111111111111111111111111111111111111111
100000000000000000000000000000000000000000000000000000000000000000000000000000000000000000000000000001
100000000000000000000000000000000000000000000000000000000000000000000000000000000000000000000000000001
100000000000000000000000000000000000000000000000000000000001111111111111111110000000000000000000000001
100000000000000000000000000000000000000000000000000000000100000000000000000000100000000000000000000001
111111111111111111111111111111111111111111111111111111111111000000000000000011111111111111111111111111
                                                           100000000000000001
                                                           100000111111110001
                                                           100000100000010001
11111111111111111111111111111111111                        10000010000001000111111111111111111
10000000000000000000000000000000001                        10000011111111000000000000000000001
100000000000000S0000000000000000001                        10000000000000000111111111111111101
10000000000000000000000000000110001                        10000011111110111100000000000001101
10001111111111111111111111111111001                        10011010000010100111111111111111101
10001000000000000000000000000000001                        10011010000010100000000000000000001
10001111111111111111111111111111111                        10111010000010111111111111111111111
10000000000000000000000000000000001                        101110111111101
11111111111111111111111111111111101111111111111111111111111101110000111001
                                100000000000000000000000000000011110111011
                                11111111111111111111111111111100000000001
                                                             101111111111
                                                            1001
                                                           1001
                                                          1001
                                                         1001
                                                        1001
                                                       1001
                                                      1001
                                                     1001
                                                    1001
                                                   1001
                                                  1001
                                                 1001
                                                1001
                                               1001
                                              1001
                                           1111001111
                                           1000000001
                                           1000600001
                                           1000000001
                                           1111111111
