NO textures/256cobble.xpm
WE textures/256mosscobble.xpm
SO textures/256stone.xpm
EA textures/256stone2.xpm


C 102,102,102
F 37,49,32


111111111111111111111111111111111111111111111111111111111111111111111111111111111111111111111111111111
123000000000000000000000000000000000000000000000000000000000000000000000000000000000000000000000000051
122200000000000000000000000000000000000000000000000000000000000000000000000000000000000000000000000011
122200000000000000000000000000000000000000000000000000000001141111111111114110000000000000000000000011
123000000000000000000000000000000000000000000000000000000100000000000000000000100000000000000000000051
111111111111111111111111111111111111111111111111111111111111000000000000000011111111111111111111111111
                                                           100000000000000001
                                                           100000111111110001
                                                           100000100000010001
11111111111111111111111111111111111                        15000010000001000111111111111111111
15200000000000000000000000000000031                        15000011111111000000022223223220001
122000000000000S0000000000000000001                        10000000000000000111111111111111101
10000000000000000000000000000110001                        10000011111110141100000000000001121
10001111111111111111111111111111001                        10011010000010100111111111111111101
10001000000000000000000000000000031                        10011010000010120003000003000000031
10001111111111111111111111111111111                        10111010000010111111111111111111111
13000000000000000000000000000000031                        101110111111101
11111111111111111111111111111111101111111111111111111111111101110000111001
                                130000000000000000000000000000011110111011
                                11111111111111111111111111111100000000001
                                                             101111111111
                                                            1001
                                                           1001
                                                          1001
                                                         1001
                                                        1001
                                                       1001
                                                      1001
                                                     1001
                                                    1001
                                                   1001
                                                  1001
                                                 1001
                                                1001
                                               1001
                                              1001
                                           1111001111
                                           1000000561
                                           1000000251
                                           1000000001
                                           1111111111
