

NO textures/cobble.xpm
EA textures/sandstone_brick.xpm

SO textures/wood.xpm

WE textures/mossycobble.xpm



C 135,206,235

F 127,0,0 
11111111111111111111111111111
10000000001100000000000000001
10110100011100000000000010001
10010000000000000020000010001
10110000011100000000000010001
10000000001100000111011110001
111101111111110111000000100011111111
111101111111110111000000100000000001
110000001101010111010100100000400001
100000000000000011000000100000000001
100000000000000011010100100011111101
11000000110101000000000000001    1 1
11110111110101000000000000001    1 1
1000003001110000010000001000111111 1  
1000000000000000101000010100       1
1000000000100001000101000100111111 1
10000000001101000000100000001    1 1
1N000000000100000001010000001    1 1
11111111111101011111111111111    1 1
           10101                 1 1
           10101111111111111111111 1
           10000                   1
           111111111111 111111111111
                      1 1
11111111111111111111111 11111111111111111111111111111111
1                                                      1
1 0                                          1111111   1
1 0  0                                       1         1
1 0                                          1111111   1
1                                                      1
11111111111111111111111111111111111111111111111111111111
