

NO textures/cobble.xpm
EA textures/sandstone_brick.xpm

SO textures/wood.xpm

WE textures/mossycobble.xpm



C 135,206,235

F 127,0,0 
11111111111111111111111111111
10000000001100000000000000001
10110100011100000000000010001
10010000000000000000000010001
10110000011100000000000010001
10000000001100000111011110001
11110111111111011100000010001111111111111111111111111111
11110111111111011100000010000000000                    1
11000000110101011101010010000000000          11        1
10000000000000001100000010000000000     11   11        1
100000000000000011010100100011111101    11       11    1
11000000110101000000000000001    1 1             11    1
11110111110101000000000000001    1 1                   1
1000000001110000010000001000111111 1  11     11        1
1000000000000000101000010100       1  11     11        1
1000000000100001000101000100111111 1                   1
10000000001101000000100000001    1 1      11      11   1
10000000000100000001010000001    1 1      11      11   1
11111111111101011111111111111    1 1                   1
           10101                 1 1  11               1
           10101111111111111111111 1  11      11       1
           10000                   1          11       1
           111111111111 111111111111     11        11  1
                      1 1          1     11        11  1
11111111111111111111111 1111111111111   11111    1111  1
1                                                      1
1 0                                          1111111   1
1 0  3           E              2            1         1
1 0                                          1111111   1
1                                                      1
11111111111111111111111111111111111111111111111111111111
