

NO textures/cobble.xpm
EA textures/sandstone_brick.xpm

SO textures/wood.xpm

WE textures/mossycobble.xpm



C 135,206,235

F 102,0,0
11111111111111111111111111111
10000000001100000000000000001
10110100011100000000000010001
10310000000000000000000010001
10110000011100000000000010001
10000000001100000111011110001
111101111111110111000000100011111111
111101111111110111000000100000000001
110000001101010111010100100000000001
100000000000000011003000100000000001
100000000000000011010100100011111101
11000000110101000000000000001    1 1
11110111113101000000000000001    1 1
1000000001110000010000001000111111 1  
1000000000000000101000013100       1
1000N00000100001000101020100111111 1
10000000001101000000100000001    1 1
10000000003100000001010000001    1 1
11111111111101011111111111111    1 1
           10101                 1 1
           10101111111111111111111 1
           10000                   1
           1111111111111111111111111
